1111
1P01
1E01
1001
1001
1C01
1101
1101
1001
1111