1111111111111111111111111111111111
1E1000000000100C00000C000000000001
1000000000001000101001000W00010101
1000000000101010001001000000010101
1P0000000C10C0100000000000000000C1
1111111111111111111111111111111111